NO ./textures/north_texture.xpm
SO ./textures/south_texture.xpm
WE ./textures/west_texture.xpm
EA ./textures/east_texture.xpm

F 154, 123, 80
C 157, 146, 92

                             1111111111     11111111111111111111
                            11000000011     10000000111000000001
                           11000000011      100000011 1000000001
                          11000000011       10000011  1000000001
                         11000000011        1000011   1000000001
                        11000000011         100011    1000000001
                       11000000011          10011     1000000001
                      11000000011           1011      1000000001
                     11000000011            111       1000000001      
                    11000000011                      11000000011
                   11000000011                      11000000011
                  11000000011                      11000000011
                 11000000011                      11000000011 
                11000000011                      11000000011
               11000000011                      11000000011
              11000000011                      11000000011   111
             11000000011                      11000000011   1101
            11000000011                      11000000011   11001
           1100000001111111111111111111     11000000011   110001
           11000000000000000000000000011111111000000011  1100001
           1100N000000000000000000000000000000000000011 11000001
           11000000000000000000000000011111111000000011110000001
           1111111111111111111000000001     11111111111111111111
                             1000000001
                             1000000001
                             1000000001           
                             1111111111  
