NO ./textures/brickWall.xpm
SO ./textures/brickWall.xpm
WE ./textures/brickWall.xpm
EA ./textures/brickWall.xpm

F 154, 123, 80
C 157, 146, 92

        1111111111111111111111111
        1N00000000110000000000001
        1011000001110000000000001
        1001000000000000000000001
111111111011000001110000000000001
100000000011000001110111111111111
11110111111111011100000010001
11110111111111011101010010001
11000000110101011100000010001
10000000000000001100000000001
10000000000000001101010010001
11000001110101011111011110001
11110111 1110101 101111010001
11111111 1111111 111111111111