NO ./textures/north_texture.xpm
SO ./textures/south_texture.xpm
WE ./textures/west_texture.xpm
EA ./textures/east_texture.xpm

F 154, 123, 80
C 157, 146, 92

1111111111111111111111111111111111111111111111111
1100000000000000000000000000000000000000000000001
1000000000000000000000000000000000000000000000001
1000000000000000000000000000000000000000000000001
1000010010010010010010010100100100100100100100101
1000000000000000000000000000000000000000000000001
1000000000000000000000000000000000000000000000001
1000000000000000000000000000000000000000000000001
1000010010010010010010010100100100100100100100101
1000000000000000000000000000000000000000000000001
1000000000000000000000000000000000000000000000001
1000000000000000000000000000000000000000000000001
1000010010010010010010010100100100100100100100101
1000000000000000000000000000000000000000000000001
1000000000000000000000000000000000000000000000001
1000000000000000000000000000000000000000000000001
1000000000000000000000000000000000000000000000001
1000000000000000000000000000000000000000000000001
10N0010000010010010010010100000100100100000100001
1101111101111111110111111111011111111111011111011
1101   101       101       101         101   1011
1101111101111111110111111111011111111111011111011
1100000000000000000000000000000000000000000000011
1111111111111111111111111111111111111111111111111